2
5 5
#####
#...#
#.@.#
#...#
#####
7 19
###################
#.................#
#.#################
#...###.........#..
#.@.#.###########..
#...###............
#####..............
